1111111111
1500001111
1111011111
111A0011a1
1110100001
1b001B1111
1111101191
1001100101
1000110001
1111111111