1111111111
1500001111
1111011111
111A0011a1
1110100001
1B001b1111
1011111191
1001110101
1000000001
1111111111